2222222222222222222222222222222222222222222222222222222222222
2222222222222222222222222222222222222222222222222222222222222
2222222222222222222222222222222222222222222222222222222222222
2222111111111111111111111122222222222222222222222222222222222
2222111111111111111111111122222222222222222222222222222222222
2222111111111011100111111122222222222222222222222222222222222
2222111112111011111111111122222222222222222222222222222222222
2222111111111110011111111222222222222222222222222222222222222
2222111111111110000000111222222222222222222222222222222222222
2222111111111110000110111222222222222222222222222222222222222
2222111111111110000110111122222222222222222222222222222222222
2222111111100000001100111122222222222222222222222222222222222
2222111111000000001111111122122222222222222222222222222222222
2222112111110000011111111121111222222222222222222222222222222
2222112111110001100001111111221222222222222222222222222222222
2222111111111101001010111111222222222222222222222222222222222
2222111111111100011010111111222222222222222222222222222222222
1122111111111110001011111111122222222222222222222222222222222
2112111111111111100011111111122222222222222222222222222222222
2111111111111111100111111111122222222222222222222222222222222
1121111111111111110111111111222222222222222222222222222222222
2222111112111111111111111111222222222222222222222222222222222
2222111112111111111111111112222222222222222222222222222222222
2222222222222222222222222222222222222222222222222222222222222
2222222222222222222222222222222222222222222222222222222222222
2222222222222222222222222222222222222222222222222222222222222
2222222222222222222222222222222222222222222222222222222222222
2222222222222222222222222222222222222222222222222222222222222
2222222222222222222222222222222222222222222222222222222222222
2222222222222222222222222222222222222222222222222222222222222
2222222222222222222222222222222222222222222222222222222222222
2222222222222222222222222222222222222222222222222222222222222
