3333030000000000000033330333003333333333330300000222222222221111
0333300000000000000000003333333333300033033300000222222222221111
3033300000000000000000000303333333333300333330000222222222221111
3330000000000000000000000030303333300333330300000022222222221111
3000000000000000000000000033300033033033033300000022222222221111
0000000000000000000000000033333000333333333300000022222222222111
0000022222222200000000000000330333333333333000000002222222222211
0002222222222222222000000000003333300333333300000002222222222222
0002222222222222222222000000000000033300003300000002222222222222
0002222222222222222222200000000000000000000000000000222222222222
0000222222222222222222222222200000000000000000000000222222222222
0000222222222222222222222222200000000000000000000000022222222222
0000222222222122222222222222200000000000000000000000022222222222
0000222222221112222222222222200000000000002200000000002222222222
0000222222211111122222222222222200000000002220000000002222222222
0000022222211111112222222222222220000000000222000000000222222222
0000022222221111111222222222222222000000000212200000000222222222
0000022222222111111222222222222222000000000021200000000002222222
0000022222222221111222222222222222200000000002200000000000222222
0000000222222222212222222222222222200000000002220000000000022222
0000000222222222222222222222222222220000000000222000000000002222
0000000022222222222222222222222222220000000000022000000000000222
0000000022222222222222222222222222220000000000000000000000000000
0000000002222222222222222222222222220000000000000000000000000000
3333000000022222222222222222222222220000000000000000000000000000
3003000000000222222222222222222222220000000000000000000000000000
3033000000000022222222222222222222200000000000000000000000000000
3033300000000000222222222222222222000000000000000000000000000000
3003333333000000022222222222222000000003000000000002222222000000
3303333303330000000022222222200000000333330000000022222222200000
3333330333330000000000000000000000033333330000022222222222200000
3333330223333300000000000000000003333333330000222222222222200000
0333332233333330000000000000000033333333330002222222222222000000
0030033333033333000000000000000333333333330002222222222222000000
0033302333333333333300000000003333333333300002222222222220000000
3333302333333333000330000000003333333333300002222222222220000000
0033333333033333333300000000003033333333000002222222222200000000
0033303222003330000000000000003333333333000000222222222000000000
0000333000033000000000000000000333333330000000222222200000000000
0000033333300000000000000000000000333000000000000000000000000000
0000002220002222200022222000000000000000000000000000000000000000
0002222222220220000022222022220002222000000000020000000000000000
0000222222220222000002200002200000220000000002220000000000000000
0000222233222222000002200002200000220000222222220000000000000000
0000222233322022000002220002220000220022222222220000000000002222
0000022200322022200002220002220000220022200000020000000000222222
0000022000322022200000220002120000220022000000000000000002222222
0000022000332002200000220002122000220022000000000000000022222211
0000022000032002200000220002122200220022000000000000000022222111
0000022000022002200002220002122200220022000020000000000022222111
0000022300022002200002200022202200220022000220000000000022222111
0000022333022002200002200022002220220022222220000000000022222211
0000022333322002200022200022000220220022222220000000000022222222
0000022333222002200022000022000222220022000020000000000002222222
0000022332220002220222000022000022220022000000000200000000000000
0000022332220000220220000222000022220022000000002200000003300000
0000022222200000222220000220000002220022000222222200000333000000
0000222222000000222220002222000022222022222222222200033330000000
0000000022220000000000000000000000220022222200000200333330000000
0000002222222222222000000000333330030000000000000000333330000222
0000222222222222222222000003333333033000000000000000333300022222
0222222222222222222222000033333333333300000000000000000000222222
2222222222211112222222220033333333333333000000000000000000222222
2222222222111111122222220033333333333300000000000000000000222222
