2222222222222222222222222222222222222222222222222222222222222222
1111111111111111111111111111111222222222222222222222222222222222
1222222222222222222222222222221222222222222222222222222222222222
1222221222222222222222222222221222222222222222222222222222222222
1222221112222222222222222222221212222211122222222222222222222212
1222221221112222222222222222221212222211122222222222222222222212
1222221222222112222222222222221212222211122222222222222222222212
1222221222222221222202222222221212222211122222222222222222222212
1222222122222222222222222222221212222211122222222222222222222212
1222222122222222222222222222221212222211122222222222222222222212
1222222112222222202222222222221212222221122222222022222222222212
1222222211222222222222222222221212222221122222222022222222222212
1222222222222222222222222222221212222221122222222022222222222212
1222222222222222222222222222221212222221122222222022222222222212
1222222222222222022222222222221212222221122222222022222222222212
1222222222222222222222222222221212222222222222222222222222222212
1222222222222222222222222222221212222222222222222222222222222212
1222222222222222222222222222221212222222222222222222222222222212
1222222222222222222222222222221212222222222222222222222222222212
1222222222222222222222222222221212222222222222222222222222222212
1222222222222222222222222222221212222222222222222222222222222212
1222222222222222222222222222221212222222222222222222222222222212
2122222222222222222222222222221212222222222222222222222222222212
2112222222222222211111111111111212222222222222222222222222222212
2211111111111111122222222222211212222222222222222222222222222212
2222222222222222222222222222222212222222222222222222222222222212
2222222222222222222222222222222212222222222222222222222222222212
2222222222222222222222222222222212222222222222222222222222222212
2222222222222222222222222222222212222222222222222222222222222212
2222222222222222222222222222222212222222222222222222222222222212
2222222222222222222222222222222212222222222222222222222222222212
2222222222222222222222222222222212222222222222222222222222222212
