22222222222222222222222222222222
11111111111111111111111111111112
12222222222222222222222222222212
12222212222222222222222222222212
12222211122222222222222222222212
12222212211122222222222222222212
12222212222221122222222222222212
12222212222222212222022222222212
12222221222222222222222222222212
12222221222222222222222222222212
12222221122222222022222222222212
12222222112222222222222222222212
12222222222222222222222222222212
12222222222222222222222222222212
12222222222222220222222222222212
12222222222222222222222222222212
12222222222222222222222222222212
12222222222222222222222222222212
12222222222222222222222222222212
12222222222222222222222222222212
12222222222222222222222222222212
12222222222222222222222222222212
21222222222222222222222222222212
21122222222222222111111111111112
22111111111111111222222222222112
22222222222222222222222222222222
22222222222222222222222222222222
22222222222222222222222222222222
22222222222222222222222222222222
22222222222222222222222222222222
22222222222222222222222222222222
22222222222222222222222222222222
