22222222222222222222222222222222
22222222222222222222222222222222
22222222222222222222222222222222
22221111111111111111111111222222
22221111111111111111111111222222
22221111111110111001111111222222
22221111121110111111111111222222
22221111111111100111111112222222
22221111111111100000001112222222
22221111111111100001101112222222
22221111111111100001101111222222
22221111111000000011001111222222
22221111110000000011111111221222
22221121111100000111111111211112
22221121111100011000011111112212
22221111111111010010101111112222
22221111111111000110101111112222
11221111111111100010111111111222
21121111111111111000111111111222
21111111111111111001111111111222
11211111111111111101111111112222
22221111121111111111111111112222
22221111121111111111111111122222
22222222222222222222222222222222
22222222222222222222222222222222
22222222222222222222222222222222
22222222222222222222222222222222
22222222222222222222222222222222
22222222222222222222222222222222
22222222222222222222222222222222
22222222222222222222222222222222
